[
    {
        "id": 1,
        "blueprint": [
            ["1", "-", "-", "-", "-", "-", "-", "-", "-", "-", "2"],
            ["|", "O", ".", ".", ".", ".", ".", ".", ".", ".", "|"],
            ["|", ".", "b", ".", "[", "7", "]", ".", "b", ".", "|"],
            ["|", ".", ".", ".", ".", "_", ".", ".", ".", ".", "|"],
            ["|", ".", "[", "]", ".", ".", ".", "[", "]", ".", "|"],
            ["|", ".", ".", ".", ".", "^", ".", ".", ".", ".", "|"],
            ["|", ".", "b", ".", "[", "+", "]", ".", "b", ".", "|"],
            ["|", ".", ".", ".", ".", "_", ".", ".", ".", ".", "|"],
            ["|", ".", "[", "]", ".", ".", ".", "[", "]", ".", "|"],
            ["|", ".", ".", ".", ".", "^", ".", ".", ".", ".", "|"],
            ["|", ".", "b", ".", "[", "5", "]", ".", "b", ".", "|"],
            ["|", ".", ".", ".", ".", ".", ".", ".", ".", "G", "|"],
            ["4", "-", "-", "-", "-", "-", "-", "-", "-", "-", "3"]
        ]
    },
    {
        "id": 2,
        "blueprint": [
            ["1", "-", "-", "-", "-", "-", "-", "-", "-", "-", "-", "-", "-", "-", "-", "-", "-", "-", "-", "-", "-", "-", "2"],
            ["|", "O", ".", ".", ".", ".", ".", ".", ".", ".", ".", ".", ".", ".", ".", ".", ".", ".", ".", ".", ".", ".", "|"],
            ["|", ".", "b", ".", "[", "7", "]", ".", "b", ".", "[", "7", "]", ".", "b", ".", "[", "7", "]", ".", "b", ".", "|"],
            ["|", ".", ".", ".", ".", "_", ".", ".", ".", ".", ".", "_", ".", ".", ".", ".", ".", "_", ".", ".", ".", ".", "|"],
            ["|", ".", "[", "]", ".", ".", ".", "[", "]", ".", ".", ".", ".", ".", "[", "]", ".", ".", ".", "[", "]", ".", "|"],
            ["|", ".", ".", ".", ".", "^", ".", ".", ".", ".", ".", "^", ".", ".", ".", ".", ".", "^", ".", ".", ".", ".", "|"],
            ["|", ".", "b", ".", "[", "+", "]", ".", "b", ".", "[", "+", "]", ".", "b", ".", "[", "+", "]", ".", "b", ".", "|"],
            ["|", ".", ".", ".", ".", "_", ".", ".", ".", ".", ".", "_", ".", ".", ".", ".", ".", "_", ".", ".", ".", ".", "|"],
            ["|", ".", "[", "]", ".", ".", ".", "[", "]", ".", ".", ".", ".", ".", "[", "]", ".", ".", ".", "[", "]", ".", "|"],
            ["|", ".", ".", ".", ".", "^", ".", ".", ".", ".", ".", "^", ".", ".", ".", ".", ".", "^", ".", ".", ".", ".", "|"],
            ["|", ".", "b", ".", "[", "+", "]", ".", "b", ".", "[", "+", "]", ".", "b", ".", "[", "+", "]", ".", "b", ".", "|"],
            ["|", ".", ".", ".", ".", "_", ".", ".", ".", ".", ".", "_", ".", ".", ".", ".", ".", "_", ".", ".", ".", ".", "|"],
            ["|", ".", "[", "]", ".", ".", ".", "[", "]", ".", ".", ".", ".", ".", "[", "]", ".", ".", ".", "[", "]", ".", "|"],
            ["|", ".", ".", ".", ".", ".", ".", ".", ".", ".", "[", "-", "]", ".", ".", ".", ".", ".", ".", ".", ".", ".", "|"],
            ["|", ".", "b", ".", ".", "1", "2", ".", ".", ".", ".", ".", ".", ".", ".", ".", "1", "2", ".", ".", "b", ".", "|"],
            ["|", ".", ".", ".", ".", "|", "|", ".", ".", "^", "J", "J", "J", "^", ".", ".", "|", "|", ".", ".", ".", ".", "|"],
            ["|", ".", "b", ".", "[", "+", "-", "]", ".", "|", "*", "*", "*", "|", ".", "[", "-", "+", "]", ".", "b", ".", "|"],
            ["|", ".", ".", ".", ".", "|", "|", ".", ".", "|", "*", "G", "*", "|", ".", ".", "|", "|", ".", ".", ".", ".", "|"],
            ["|", ".", "b", ".", ".", "4", "3", ".", ".", "4", "-", "-", "-", "3", ".", ".", "4", "3", ".", ".", "b", ".", "|"],
            ["|", ".", ".", ".", ".", ".", ".", ".", ".", ".", ".", ".", ".", ".", ".", ".", ".", ".", ".", ".", ".", ".", "|"],
            ["|", ".", "[", "]", ".", ".", ".", "[", "]", ".", ".", ".", ".", ".", "[", "]", ".", ".", ".", "[", "]", ".", "|"],
            ["|", ".", ".", ".", ".", "^", ".", ".", ".", ".", ".", "^", ".", ".", ".", ".", ".", "^", ".", ".", ".", ".", "|"],
            ["|", ".", "b", ".", "[", "5", "]", ".", "b", ".", "[", "5", "]", ".", "b", ".", "[", "5", "]", ".", "b", ".", "|"],
            ["|", ".", ".", ".", ".", ".", ".", ".", ".", ".", ".", "G", ".", ".", ".", ".", ".", ".", ".", ".", ".", ".", "|"],
            ["4", "-", "-", "-", "-", "-", "-", "-", "-", "-", "-", "-", "-", "-", "-", "-", "-", "-", "-", "-", "-", "-", "3"]
        ]
    }
]